11111
1P0E1
11111
100C1
11111
