1111111111111
1P0C0000110C1
100E1110C0001
1C0010C001101
1111111111111
